а=a
ɐ=ɐ
б=b
бь=bʲ
в=v
вь=vʲ
β=β
βь=βʲ
г=ɣ
гь=ɣʲ
ґ=g
ґь=gʲ
д=d
дь=dʲ
э=ɛ
дж=d͡ʐ
дз=d͡z
дзь=d͡zʲ
ж=ʐ
з=z
зь=zʲ
і=i
к=k
кь=kʲ
л=ɫ
ль=lʲ
м=m
мь=mʲ
ɱ=ɱ
н=n
нь=nʲ
о=ɔ
п=p
пь=pʲ
р=r
с=s
сь=sʲ
т=t
ть=tʲ
у=u
ў=u̯
ф=f
фь=fʲ
х=x
хь=xʲ
ц=t͡s
ць=t͡sʲ
ч=t͡ʂ
ш=ʂ
ы=ɨ
ə=ə
j=j
