а=a
ɐ=ɐ
б=b
бь=bʲ
в=w
вь=wʲ
β=ʋ
βь=ʋʲ
г=ɦ
гь=ɦʲ
ґ=ɡ
ґь=ɡʲ
д=d
дь=dʲ
э=ɛ
дж=d͡ʒ
дз=d͡z
дзь=d͡zʲ
ж=ʒ
з=z
зь=zʲ
і=i
к=k
кь=kʲ
л=ɫ
ль=lʲ
м=m
мь=mʲ
ɱ=ɱ
н=n
нь=nʲ
о=ɔ
п=p
пь=pʲ
р=r
с=s
сь=sʲ
т=t
ть=tʲ
у=u
ў=u̯
ф=f
фь=fʲ
х=x
хь=xʲ
ц=t͡s
ць=t͡sʲ
ч=t͡ʃ
ш=ʃ
ы=ɪ
ə=ɪ
j=j
